width 16
height 12
data
9 9 9 9 9 9 9 9 9 9 9 9 9 9 9 9 
9 0 0 0 0 0 0 9 9 0 0 0 0 0 0 9 
9 0 0 0 0 0 0 9 9 0 0 0 0 0 0 9 
9 0 0 0 0 0 0 0 0 0 0 0 0 0 0 9 
9 0 0 0 0 0 0 0 0 0 0 0 0 0 0 9 
9 0 0 0 9 9 0 0 0 0 9 9 0 0 0 9 
9 0 0 0 9 9 0 0 0 0 9 9 0 0 0 9 
9 0 0 0 0 0 0 0 0 0 0 0 0 0 0 9 
9 0 0 0 0 0 0 0 0 0 0 0 0 0 0 9 
9 0 0 0 0 0 0 9 9 0 0 0 0 0 0 9 
9 0 0 0 0 0 0 9 9 0 0 0 0 0 0 9 
9 9 9 9 9 9 9 9 9 9 9 9 9 9 9 9